NO ./game_data/textures/north.xpm
SO ./game_data/textures/south.xpm
WE ./game_data/textures/west.xpm
EA ./game_data/textures/east.xpm

F 155,118,111
C 135,206,235

111111111
100001101
101000101
100010001
1010S0101
100000101
111101111
100101111
110101111
110001101
100000001
100100101
100001101
111111111