NO ./game_data/textures/poles_textures/north.xpm
SO ./game_data/textures/poles_textures/south.xpm
WE ./game_data/textures/poles_textures/west.xpm
EA ./game_data/textures/poles_textures/east.xpm

F 0,0,25
C 255,255,255

111111111
100000101
100000101
100000001
100000101
1W0000101
111111111