NO ./textures/banner.xpm
SO ./textures/wall_3.xpm
WE ./textures/wall_3.xpm
EA ./textures/hitler.xpm

F 155,118,111
C 135,206,235

111111111
100001101
101000101
100010001
101000101
100000101
111101111
100101111
110101111
110001101
1000000C1
100100101
1000011S1
111111111
